11111111111111111111111
1C000010000000000000P01
111110100A0000000000001
1110A010000000C00000001
10001110000000111111001
1C1A0000000000100A01001
11100000000000101101111
1E000000A000000001000C1
11111111111111111111111
